4 4 4 4 4 4 4 4 4 4 4 4 4 4 4 4 4 4 4 4 4 4 4 4 4 4 4 4 4 4 4 4 4 4 4 4 4 4 4 4 4 4 4 4 4 4 4 4 4 4 
4 4 4 4 14 23 23 23 23 23 23 23 23 23 23 19 4 4 4 4 4 4 4 4 4 4 4 4 4 4 4 4 4 4 4 4 4 4 4 4 4 4 4 4 4 4 4 4 4 4 
4 4 4 4 14 4 4 21 4 4 21 4 21 4 4 19 4 4 4 4 4 4 4 4 4 4 4 4 4 4 4 4 4 4 4 4 4 4 4 4 4 4 4 4 4 4 4 4 4 4 
4 4 4 4 0 16 10 26 10 26 26 10 16 26 10 19 4 4 4 4 4 4 4 4 4 4 4 4 4 4 4 4 4 4 4 4 4 4 4 4 4 4 4 4 4 4 4 4 4 4 
4 4 4 4 25 72 16 67 16 27 67 27 4 4 72 19 4 4 4 4 4 4 4 4 4 4 4 4 4 4 4 4 4 4 4 4 4 4 4 4 4 4 4 4 4 4 4 4 4 4 
4 4 4 4 25 4 21 67 10 27 21 67 67 67 7 8 4 4 4 4 4 4 4 4 4 4 4 4 4 4 4 4 4 4 4 4 4 4 4 4 4 4 4 4 4 4 4 4 4 4 
4 4 4 4 25 10 5 4 5 21 4 67 27 7 4 19 4 4 4 4 4 4 4 4 4 4 4 4 4 4 4 4 4 4 4 4 4 4 4 4 4 4 4 4 4 4 4 4 4 4 
4 4 4 4 14 4 4 4 16 4 4 67 4 16 4 19 4 4 4 4 4 4 4 4 4 4 4 4 4 4 4 4 4 4 4 4 4 4 4 4 4 4 4 4 4 4 4 4 4 4 
4 4 4 4 14 4 21 27 21 67 4 16 4 16 7 19 4 4 4 4 4 4 4 4 4 4 4 4 4 4 4 4 4 4 4 4 4 4 4 4 4 4 4 4 4 4 4 4 4 4 
4 4 4 4 14 72 4 21 4 4 7 21 4 16 72 8 4 4 4 4 4 4 4 4 4 4 4 4 4 4 4 4 4 4 4 4 4 4 4 4 4 4 4 4 4 4 4 4 4 4 
4 4 4 4 36 38 38 50 38 31 32 38 51 38 38 41 4 4 4 4 4 4 4 4 4 4 4 4 4 4 4 4 4 4 4 4 4 4 4 4 4 4 4 4 4 4 4 4 4 4 
4 4 4 4 4 4 4 25 4 4 4 9 30 4 4 4 4 4 4 4 4 4 4 4 4 4 4 4 4 4 4 4 4 4 4 4 4 4 4 4 4 4 4 4 4 4 4 4 4 4 
4 4 4 4 4 4 4 25 21 4 21 9 30 4 4 4 4 4 4 4 4 4 4 4 4 4 4 4 4 4 4 4 4 4 4 4 4 4 4 4 4 4 4 4 4 4 4 4 4 4 
4 4 4 4 4 4 4 25 4 10 9 9 30 4 4 4 4 4 4 4 4 4 4 4 4 4 4 4 4 4 4 4 4 4 4 4 4 4 4 4 4 4 4 4 4 4 4 4 4 4 
4 4 4 4 4 4 4 25 4 4 9 9 30 4 4 4 4 4 4 4 4 4 4 4 4 4 4 4 4 4 4 4 4 4 4 4 4 4 4 4 4 4 4 4 4 4 4 4 4 4 
4 4 4 4 4 4 4 25 4 10 4 10 30 4 4 4 4 4 4 4 4 4 4 4 4 4 4 4 4 4 4 4 4 4 4 4 4 4 4 4 4 4 4 4 4 4 4 4 4 4 
4 4 4 4 4 4 4 25 4 4 10 4 30 4 4 4 4 4 4 4 4 4 4 4 4 4 4 4 4 4 4 4 4 4 4 4 4 4 4 4 4 4 4 4 4 4 4 4 4 4 
4 4 4 4 4 4 4 25 4 10 10 21 30 4 4 4 4 4 4 4 4 4 4 4 4 4 4 4 4 4 4 4 4 4 4 4 4 4 4 4 4 4 4 4 4 4 4 4 4 4 
4 4 4 4 4 4 4 25 4 4 10 4 30 4 4 4 4 4 4 4 4 4 4 4 4 4 4 4 4 4 4 4 4 4 4 4 4 4 4 4 4 4 4 4 4 4 4 4 4 4 
4 4 4 4 4 4 4 25 4 10 4 10 30 4 4 4 4 4 4 4 4 4 4 4 4 4 4 4 4 4 4 4 4 4 4 4 4 4 4 4 4 4 4 4 4 4 4 4 4 4 
4 4 4 4 4 4 4 25 4 10 10 4 30 4 4 4 4 4 4 4 4 4 79 4 4 4 4 25 23 23 23 23 23 23 23 23 23 23 23 23 23 23 23 23 8 4 4 4 4 4 
4 4 4 4 4 4 4 25 4 10 4 10 30 4 4 4 4 4 4 4 4 4 79 4 4 4 4 25 4 4 4 4 4 21 21 21 7 7 7 10 10 4 4 4 8 4 4 4 4 4 
4 4 3 12 12 23 23 12 23 31 32 12 12 23 23 12 12 8 4 4 79 4 4 4 4 4 4 25 4 4 7 4 4 11 17 7 58 58 7 21 4 10 10 11 8 4 4 4 4 4 
4 4 14 6 4 4 29 4 4 4 4 4 4 4 4 29 4 51 12 23 23 23 23 23 23 23 23 25 21 4 7 58 21 7 67 7 61 58 58 58 58 58 10 11 8 4 4 4 4 4 
4 4 3 6 11 11 4 4 4 11 29 4 4 4 29 29 4 8 4 4 4 9 4 4 29 4 21 25 21 4 7 58 58 7 61 61 15 15 15 7 15 58 21 4 8 4 4 4 4 4 
4 4 14 6 4 21 29 11 21 4 4 4 11 11 4 4 4 43 4 29 27 29 27 26 21 27 26 44 4 21 29 11 58 7 67 61 67 67 15 7 7 58 21 4 8 4 4 4 4 4 
4 4 14 6 4 4 4 29 4 11 4 4 29 11 4 29 4 54 4 26 29 4 21 21 29 21 26 55 4 4 29 11 58 29 17 7 58 15 15 17 58 7 21 11 8 4 4 4 4 4 
4 4 3 6 11 4 21 21 4 21 11 11 4 29 4 4 29 8 4 4 29 29 21 21 26 21 21 3 4 4 4 29 58 17 7 7 61 15 15 15 58 58 11 7 8 4 4 4 4 4 
4 4 14 6 4 29 4 4 29 4 29 4 29 29 4 4 4 47 40 40 49 37 49 37 49 37 37 38 4 4 58 15 58 70 7 7 7 7 10 15 15 58 11 11 8 4 4 4 4 4 
4 4 36 48 48 48 38 48 38 48 38 48 38 48 48 37 38 41 4 4 4 4 4 4 4 4 4 25 4 4 4 15 58 70 7 67 67 7 7 7 7 7 11 11 8 4 4 4 4 4 
4 4 4 4 4 4 4 4 4 4 4 4 4 4 4 4 4 4 4 4 4 4 4 4 4 4 4 25 4 4 4 4 15 15 15 15 15 7 7 11 11 4 4 4 8 4 4 4 4 4 
4 4 4 4 4 4 4 4 4 4 4 4 4 4 4 4 4 4 4 4 4 4 4 4 4 4 4 36 40 40 40 40 40 40 40 40 50 22 22 22 47 40 40 40 41 4 4 4 4 4 
4 4 14 12 12 12 12 12 12 12 12 12 12 12 12 12 12 12 12 12 12 12 12 12 12 12 8 4 4 4 4 4 4 4 4 4 3 4 4 4 30 4 4 4 4 4 4 4 4 4 
4 4 25 4 4 4 4 4 4 4 4 4 4 4 4 4 4 4 4 4 4 4 4 4 4 4 8 4 4 4 4 4 4 4 4 4 3 4 4 4 30 4 4 4 4 4 4 4 4 4 
4 4 3 4 4 4 4 4 4 4 4 4 4 4 4 4 4 4 4 4 4 4 4 4 4 6 8 4 4 4 4 4 4 4 4 4 3 4 4 4 30 4 4 4 4 4 4 4 4 4 
4 4 3 4 4 4 4 4 4 4 4 4 4 4 4 4 4 4 4 4 4 4 4 4 4 6 8 4 4 4 4 4 4 4 4 4 3 4 4 4 30 4 4 4 4 4 4 4 4 4 
4 4 3 4 4 4 4 4 4 4 4 4 4 4 4 4 4 4 4 4 4 4 4 4 4 6 8 4 4 4 4 4 4 4 4 4 3 4 4 4 30 4 4 4 4 4 4 4 4 4 
4 4 3 4 4 4 4 4 4 4 4 4 4 4 4 4 4 4 4 4 4 4 4 4 4 6 8 4 4 4 4 4 4 4 4 4 3 4 4 4 30 4 4 4 4 4 4 4 4 4 
4 4 3 4 4 4 4 4 4 4 4 4 4 4 4 4 4 4 4 4 4 4 4 4 4 6 8 4 4 4 4 4 4 4 4 4 3 4 4 4 30 4 4 4 4 4 4 4 4 4 
4 4 3 4 4 4 4 4 4 4 4 4 4 4 4 4 4 4 4 4 4 4 4 4 4 4 12 12 12 12 12 12 12 12 12 12 12 4 4 4 30 4 4 4 4 4 4 4 4 4 
4 4 3 4 4 4 4 4 4 4 4 4 4 4 4 4 4 4 4 4 4 4 4 4 4 4 4 4 4 4 5 4 4 4 4 4 4 4 4 4 30 4 4 4 4 4 4 4 4 4 
4 4 3 4 4 4 4 4 4 4 4 4 4 4 4 4 4 4 4 4 4 4 4 4 4 4 4 4 4 4 5 4 4 4 4 4 4 4 4 4 30 4 4 4 4 4 4 4 4 4 
4 4 3 4 4 4 4 4 4 4 4 4 4 4 4 4 4 4 4 4 4 4 4 4 4 4 47 37 37 37 37 37 37 37 37 37 37 37 37 37 41 4 4 4 4 4 4 4 4 4 
4 4 3 4 4 4 4 4 4 4 4 4 4 4 4 4 4 4 4 4 4 4 4 4 4 4 8 4 4 4 4 4 4 4 4 4 4 4 4 4 4 4 4 4 4 4 4 4 4 4 
4 4 3 4 4 4 4 4 4 4 4 4 4 4 4 4 4 4 4 4 4 4 4 4 4 4 8 4 4 4 4 4 4 4 4 4 4 4 4 4 4 4 4 4 4 4 4 4 4 4 
4 4 3 4 4 4 4 4 4 4 4 4 4 4 4 4 4 4 4 4 4 4 4 4 4 4 8 4 4 4 4 4 4 4 4 4 4 4 4 4 4 4 4 4 4 4 4 4 4 4 
4 4 3 4 4 4 4 4 4 4 4 4 4 4 4 4 4 4 4 4 4 4 4 4 4 4 8 4 4 4 4 4 4 4 4 4 4 4 4 4 4 4 4 4 4 4 4 4 4 4 
4 4 36 37 37 37 37 37 37 37 37 37 37 37 37 37 37 37 37 37 37 37 37 37 37 37 41 4 4 4 4 4 4 4 4 4 4 4 4 4 4 4 4 4 4 4 4 4 4 4 
4 4 4 4 4 4 4 4 4 4 4 4 4 4 4 4 4 4 4 4 4 4 4 4 4 4 4 4 4 4 4 4 4 4 4 4 4 4 4 4 4 4 4 4 4 4 4 4 4 4 
4 4 4 4 4 4 4 4 4 4 4 4 4 4 4 4 4 4 4 4 4 4 4 4 4 4 4 4 4 4 4 4 4 4 4 4 4 4 4 4 4 4 4 4 4 4 4 4 4 4 
